NO    ./assets/brick1.xpm
SO    ./assets/brick2.xpm
WE         ./assets/brick3.xpm
EA             ./assets/brick4.xpm

F                     255,255,255
C     001,00,255
   
    
    
        11111111                     11111111              
        11100011                     11     11             
11111   11111 11     1111111        11     11              
10001                1000001         11  11               
111111               11111111         11111                
                                                1111       
            111111111111111111111111111111111  11  1       
            100000000000000000000000000000001   1111       
            100000000000000000000000000000001    1         
            100000000000000000000000000000001              
            100000000000000000000000000000001              
            100000000000000000000000000000001              
            100000000000000000000000000000001              
            100000000000000000N00000000000001              
            100000000000000000000000000000001              
            100000000000000000000000000000001              
            100000000000000000000000000000001              
            111111111111111111111111111111111              
                                1                          
1111111                                                    
 11   11            111     0    11                        
  11   11           1   1             1                    
   11  11           11111       0                          
    1111                                                   
                                                           
                                                           