EA ./assets/brick4.xpm
NO ./assets/brick1.xpm
SO ./assets/brick2.xpm
WE ./assets/brick3.xpm


11111111111          111111111111      111111111111111111111111111111111
11110000001          100000000001      100000000000000000000000000000001
10010000001          100000000001      100000000000000000000000000000001
10000000001          100000000001      100000000000000000000000000000001
10000000001          100000000001      111111111110000000000111111111111
100000000011111111111100000000001                100000000001           
100000000000000000000000000000001                100011100001           
100000000000000000000000000000001                10001 100001           
100000000000000000000000000000001                100011100001           
100000000011111111111100000000001                100000000001           
10000000001          100000000001      111111111110000000000111111111111
10000000001          100000000001      100000000000000000000000000000001
10000000001          100000000001111111100000000000000000000000000000001
1000000N001          100000000000000000000000000000000000000000000000001
11111111110          1111111111111111111111111111111111111111111111111111111
