NO ./assets/sonicwall1.xpm
SO ./assets/sonicwall2.xpm
WE ./assets/sonicwall1.xpm
EA ./assets/sonicwall2.xpm

F 73,49,29
C 106,197,254

           11111111111
          1000000000001
         100000000000001
        10000000000000001
       1000000000000000001
      100000000000000000001
     10000000000000000000001
     10000000000000000000001
     10000000000000000000001
     10000000000000000000001
     100000A0001000000000001
     10000000000000000000001
     10000000000000000000001
      10000N000000000000001
       1000000000000000001
        10000000000000001
         100000000000001
          1000000000001
           11111111111