NO ./assets/stone1.xpm
SO ./assets/stone2.xpm
WE ./assets/stone3.xpm
EA ./assets/stone4.xpm

F 85,85,85
C 38,83,141

11111111111          111111111111
11110000001          100000000001
10010001001          100001000001 
10000000001          100001000001
10001110001          100000000001
100000000011111111111100000000001    
100000000000000000000000000000001        
100011100000000W00000011111110001
100011100000000000000000000000001          
100011100011111111111100000000001         
10001110001          111111111111 
10000000001
10000000001
10000000001
11111111111