NO ./assets/stone1.xpm
SO ./assets/stone2.xpm
WE ./assets/stone3.xpm
EA ./assets/stone4.xpm

F 85,85,85
C 38,83,141

           11111111111
          1000000000001
         100000000000001
        10000000000000001
       1000000000000000001
      100000000000000000001
     10000000000000000000001
     10000000000000000000001
     10000000000000000000001
     10000000000000000000001
     10000000000000000000001
     10000000000000000000001
     10000000000000000000001
      100000000000000000001
       1000000000000000001
        10000000000000001
         100000000000001
          1W00000000001
           11111111111